########
#..#####
#..#####
#......#
#......#
#####..#
#####..#
########
