########
#......#
#......#
#......#
#...#..#
#......#
#......#
########
